11111111
10000001
10100101
1E1001C1
11100001
10100001
1P100001
10000001
11111111
