1111111111
1e00000001
1000000001
1p000000c1
1111111111
