11111
1ec01
10001
1p0c1
11111
