1111111111
1e00000001
1000100001
1000100001
1000100001
1011000001
1000000001
1001111001
1p000000c1
1111111111
