1111111111
1e00000001
1000000001
100000c001
1000000001
10c0000001
1000000001
1000000001
1p000000c1
1111111111
